[--------------]
[A      - - ---]
[-- --- - - ---]
[-- --  -   ---]
[-- --- -------]
[----     -----]
[--   ---------]
[-- ---    ----]
[-- --- -  B---]
[-- --- -------]
[--        ----]
[--------------]